





                                                                                                                                                                                                  #############
                                                                                                     ################                                                      #####           ####   #############  #
                                                                                                     ################                                                  #   #####   #####   ####                  #  #
                                                                                                                                                                       #           #####                         *  #
                                                                                                                                                                       *                                            *                                                        *** * **** * *** * *
                                                                                                                                                                                                  ######    ###                                                              *   * *  * * *   * *
                                                                            #                        ###############*                                               #      ####*           ####   ######    ###  #                             #                             *** * *  * * *** ***
        @                                                  #            #   #                    #   ################                                           #   #  #   #####   #####   ####   ######    ###  #  ##########    ##########   #                             *   * *  * *   * * *
###############*##########*##*#########*#########*#######**#*#########**#####*########*########**#***################*#########*########*##*########*#########**#***#**#***#####***#####***####***######****###**#**##########****##########***#**#######*#######**########*#*###*#*##*#*#***#*#*####
 # # # # # # # # # # # # # # # # # # # # # # # # # # # # # # # # # # # # # # # # # # # # # # # # # # # # # # # # # # # # # # # # # # # # # # # # # # # # # # # # # # # # # # # # # # # # # # # # # # # # # # # # # # # # # # # # # # # # # # # # # # # # # # # # # # # # # # # # # # # # # # # # # #
# # # # # # # # # # # # # # # # # # # # # # # # # # # # # # # # # # # # # # # # # # # # # # # # # # # # # # # # # # # # # # # # # # # # # # # # # # # # # # # # # # # # # # # # # # # # # # # # # # # # # # # # # # # # # # # # # # # # # # # # # # # # # # # # # # # # # # # # # # # # # # # # # # #